WWWWWWWWWWW
W.........W
W.W.W.W.W.W
W.B.B.B.B.W
W.........W
WWWWWWWWWWW
